{
	"worlds": [
		{
			"name": "dining_hall",
			"tiles": ["void", "concrete", "marble_01", "marble_02", "ceramic", "wall_02_a", "wall_02_b", "wall_02_c"],
			"chunks": [
				{
					"position": {"x": 0, "y": 0},
					"actors": [
						{"name": "Player", "position": {"x": 5, "y": 11}}
					],
					"statics": [
						{"name": "dining_hall_counter_01_a", "positions": [{"x": 3, "y": 9}]},
						{"name": "dining_hall_counter_01_b", "positions": [{"x": 3, "y": 9}]},
						{"name": "dining_hall_counter_01_c", "positions": [{"x": 3, "y": 9}]},
						{"name": "dining_hall_counter_01_d", "positions": [{"x": 3, "y": 9}]},
						{"name": "dining_hall_counter_01_e", "positions": [{"x": 3, "y": 9}]},
						{
							"name": "dining_hall_counter_02",
							"positions": [
								{"x": 0, "y": 0}
							]
						},
						{
							"name": "dining_hall_counter_03",
							"positions": [
								{"x": 1, "y": 4}
							]
						},
						{
							"name": "dining_hall_counter_04",
							"positions": [
								{"x": 11, "y": 4}
							]
						}
					],
					"array": [
						7, 7, 7, 7, 7, 7, 7, 7, 7, 7, 7, 7, 7, 7, 7, 7,
						5, 5, 5, 5, 5, 5, 5, 5, 5, 5, 5, 5, 5, 5, 5, 5,
						6, 6, 6, 6, 6, 6, 6, 6, 6, 6, 6, 6, 6, 6, 6, 6,
						4, 4, 4, 4, 4, 4, 4, 4, 4, 4, 4, 4, 4, 4, 4, 4,
						4, 4, 4, 4, 4, 4, 4, 4, 4, 4, 4, 4, 4, 4, 4, 4,
						3, 3, 3, 3, 3, 3, 3, 3, 3, 3, 3, 3, 3, 3, 4, 4,
						3, 2, 2, 2, 1, 1, 1, 1, 2, 2, 2, 2, 1, 3, 4, 4,
						3, 2, 2, 2, 1, 1, 1, 1, 2, 2, 2, 2, 1, 3, 4, 4,
						3, 1, 1, 1, 2, 2, 2, 2, 1, 1, 1, 1, 2, 3, 4, 4,
						3, 1, 1, 4, 4, 4, 4, 4, 1, 1, 1, 1, 2, 3, 4, 4,
						3, 1, 1, 4, 4, 4, 4, 4, 1, 1, 1, 1, 2, 3, 4, 4,
						3, 1, 1, 4, 4, 4, 4, 4, 1, 1, 1, 1, 2, 3, 4, 4,
						3, 1, 1, 4, 4, 4, 4, 4, 1, 1, 1, 1, 2, 3, 4, 4,
						3, 1, 1, 4, 4, 4, 4, 4, 1, 1, 1, 1, 2, 3, 4, 4,
						3, 1, 1, 4, 4, 4, 4, 4, 1, 1, 1, 1, 2, 3, 4, 4,
						3, 1, 1, 4, 4, 4, 4, 4, 1, 1, 1, 1, 2, 3, 4, 4
					]
				},
				{
					"position": {"x": 0, "y": 1},
					"array": [
						2, 2, 2, 2, 1, 1, 1, 1, 2, 2, 2, 2, 1, 1, 1, 1,
						2, 2, 2, 2, 1, 1, 1, 1, 2, 2, 2, 2, 1, 1, 1, 1,
						2, 2, 2, 2, 1, 1, 1, 1, 2, 2, 2, 2, 1, 1, 1, 1,
						2, 2, 2, 2, 1, 1, 1, 1, 2, 2, 2, 2, 1, 1, 1, 1,
						2, 2, 2, 2, 1, 1, 1, 1, 2, 2, 2, 2, 1, 1, 1, 1,
						2, 2, 2, 2, 1, 1, 1, 1, 2, 2, 2, 2, 1, 1, 1, 1,
						2, 2, 2, 2, 1, 1, 1, 1, 2, 2, 2, 2, 1, 1, 1, 1,
						2, 2, 2, 2, 1, 1, 1, 1, 2, 2, 2, 2, 1, 1, 1, 1,
						1, 1, 1, 1, 2, 2, 2, 2, 1, 1, 1, 1, 2, 2, 2, 2,
						1, 1, 1, 1, 2, 2, 2, 2, 1, 1, 1, 1, 2, 2, 2, 2,
						1, 1, 1, 1, 2, 2, 2, 2, 1, 1, 1, 1, 2, 2, 2, 2,
						1, 1, 1, 1, 2, 2, 2, 2, 1, 1, 1, 1, 2, 2, 2, 2,
						1, 1, 1, 1, 2, 2, 2, 2, 1, 1, 1, 1, 2, 2, 2, 2,
						1, 1, 1, 1, 2, 2, 2, 2, 1, 1, 1, 1, 2, 2, 2, 2,
						1, 1, 1, 1, 2, 2, 2, 2, 1, 1, 1, 1, 2, 2, 2, 2,
						1, 1, 1, 1, 2, 2, 2, 2, 1, 1, 1, 1, 2, 2, 2, 2
					]
				},
				{
					"position": {"x": 1, "y": 1},
					"array": [
						2, 2, 2, 2, 1, 1, 1, 1, 2, 2, 2, 2, 1, 1, 1, 1,
						2, 2, 2, 2, 1, 1, 1, 1, 2, 2, 2, 2, 1, 1, 1, 1,
						2, 2, 2, 2, 1, 1, 1, 1, 2, 2, 2, 2, 1, 1, 1, 1,
						2, 2, 2, 2, 1, 1, 1, 1, 2, 2, 2, 2, 1, 1, 1, 1,
						2, 2, 2, 2, 1, 1, 1, 1, 2, 2, 2, 2, 1, 1, 1, 1,
						2, 2, 2, 2, 1, 1, 1, 1, 2, 2, 2, 2, 1, 1, 1, 1,
						2, 2, 2, 2, 1, 1, 1, 1, 2, 2, 2, 2, 1, 1, 1, 1,
						2, 2, 2, 2, 1, 1, 1, 1, 2, 2, 2, 2, 1, 1, 1, 1,
						1, 1, 1, 1, 2, 2, 2, 2, 1, 1, 1, 1, 2, 2, 2, 2,
						1, 1, 1, 1, 2, 2, 2, 2, 1, 1, 1, 1, 2, 2, 2, 2,
						1, 1, 1, 1, 2, 2, 2, 2, 1, 1, 1, 1, 2, 2, 2, 2,
						1, 1, 1, 1, 2, 2, 2, 2, 1, 1, 1, 1, 2, 2, 2, 2,
						1, 1, 1, 1, 2, 2, 2, 2, 1, 1, 1, 1, 2, 2, 2, 2,
						1, 1, 1, 1, 2, 2, 2, 2, 1, 1, 1, 1, 2, 2, 2, 2,
						1, 1, 1, 1, 2, 2, 2, 2, 1, 1, 1, 1, 2, 2, 2, 2,
						1, 1, 1, 1, 2, 2, 2, 2, 1, 1, 1, 1, 2, 2, 2, 2
					]
				}
			]
		}
	]
}