{
	"worlds": [
		{
			"name": "dining_hall",
			"tiles": ["void", "concrete", "marble_01", "marble_02", "ceramic", "wall_02_a", "wall_02_b", "wall_02_c", "wood_02", "wall_03_a", "wall_03_b", "wall_03_c"],
			"chunks": [
				{
					"position": {"x": 2, "y": 0},
					"actors": [
						{"name": "Player", "position": {"x": 5, "y": 11}}
					],
					"markers": [
						{"name": "test", "position": {"x": 5, "y": 7}}
					],
					"statics": [
						{"name": "dining_hall_counter_01_a", "positions": [{"x": 3, "y": 8}]},
						{"name": "dining_hall_counter_01_b", "positions": [{"x": 3, "y": 8}]},
						{"name": "dining_hall_counter_01_c", "positions": [{"x": 3, "y": 8}]},
						{"name": "dining_hall_counter_01_d", "positions": [{"x": 3, "y": 8}]},
						{"name": "dining_hall_counter_01_e", "positions": [{"x": 3, "y": 8}]},
						{
							"name": "dining_hall_counter_02",
							"positions": [
								{"x": 0, "y": 0}
							]
						},
						{
							"name": "dining_hall_counter_03",
							"positions": [
								{"x": 1, "y": 4}
							]
						},
						{
							"name": "dining_hall_counter_04",
							"positions": [
								{"x": 10, "y": 4}
							]
						},
						{
							"name": "wall_02_b",
							"positions": [
								{"x": 0, "y": 4, "stretch": {"x": 0, "y": 11}}
							]
						}
					],
					"array": [
						7, 7, 7, 7, 7, 7, 7, 7, 7, 7, 7, 7, 7, 7, 7, 7,
						5, 5, 5, 5, 5, 5, 5, 5, 5, 5, 5, 5, 5, 5, 5, 5,
						6, 6, 6, 6, 6, 6, 6, 6, 6, 6, 6, 6, 6, 6, 6, 6,
						4, 4, 4, 4, 4, 4, 4, 4, 4, 4, 4, 4, 4, 4, 4, 4,
						4, 4, 4, 4, 4, 4, 4, 4, 4, 4, 4, 4, 4, 4, 4, 4,
						3, 3, 3, 3, 3, 3, 3, 3, 3, 3, 3, 3, 3, 4, 4, 4,
						3, 2, 2, 2, 1, 1, 1, 1, 2, 2, 2, 2, 3, 4, 4, 4,
						3, 2, 2, 2, 1, 1, 1, 1, 2, 2, 2, 2, 3, 4, 4, 4,
						3, 1, 1, 4, 4, 4, 4, 4, 1, 1, 1, 1, 3, 4, 4, 4,
						3, 1, 1, 4, 4, 4, 4, 4, 1, 1, 1, 1, 3, 4, 4, 4,
						3, 1, 1, 4, 4, 4, 4, 4, 1, 1, 1, 1, 3, 4, 4, 4,
						3, 1, 1, 4, 4, 4, 4, 4, 1, 1, 1, 1, 3, 4, 4, 4,
						3, 1, 1, 4, 4, 4, 4, 4, 1, 1, 1, 1, 3, 4, 4, 4,
						3, 1, 1, 4, 4, 4, 4, 4, 1, 1, 1, 1, 3, 4, 4, 4,
						3, 1, 1, 4, 4, 4, 4, 4, 1, 1, 1, 1, 3, 4, 4, 4,
						3, 1, 1, 1, 2, 2, 2, 2, 1, 1, 1, 1, 3, 3, 3, 3
					]
				},
				{
					"position": {"x": 1, "y": 1},
					"statics": [
						{
							"name": "wall_03_a",
							"positions": [
								{"x": 0, "y": 8},
								{"x": 2, "y": 8, "stretch": {"x": 1, "y": 0}},
								{"x": 5, "y": 8, "stretch": {"x": 1, "y": 0}},
								{"x": 9, "y": 8, "stretch": {"x": 1, "y": 0}},
								{"x": 12, "y": 8, "stretch": {"x": 1, "y": 0}},
								{"x": 15, "y": 8}
							]
						},
						{
							"name": "wall_03_b",
							"positions": [
								{"x": 0, "y": 0, "stretch": {"x": 0, "y": 7}},
								{"x": 15.75, "y": 0, "stretch": {"x": 0, "y": 7}}
							]
						},
						{
							"name": "wall_03_d",
							"positions": [
								{"x": 7, "y": 8}
							]
						},
						{
							"name": "wall_03_e",
							"positions": [
								{"x": 1, "y": 8},
								{"x": 4, "y": 8},
								{"x": 11, "y": 8},
								{"x": 14, "y": 8}
							]
						}
					],
					"array": [
						11, 11, 11, 11, 11, 11, 11, 11, 11, 11, 11, 11, 11, 11, 11, 11,
						9, 9, 9, 9, 9, 9, 9, 9, 9, 9, 9, 9, 9, 9, 9, 9,
						10, 10, 10, 10, 10, 10, 10, 10, 10, 10, 10, 10, 10, 10, 10, 10,
						8, 8, 8, 8, 8, 8, 8, 8, 8, 8, 8, 8, 8, 8, 8, 8,
						8, 8, 8, 8, 8, 8, 8, 8, 8, 8, 8, 8, 8, 8, 8, 8,
						8, 8, 8, 8, 8, 8, 8, 8, 8, 8, 8, 8, 8, 8, 8, 8,
						8, 8, 8, 8, 8, 8, 8, 8, 8, 8, 8, 8, 8, 8, 8, 8,
						8, 8, 8, 8, 8, 8, 8, 8, 8, 8, 8, 8, 8, 8, 8, 8,
						8, 8, 8, 8, 8, 8, 8, 8, 8, 8, 8, 8, 8, 8, 8, 8,
						8, 8, 8, 8, 8, 8, 8, 8, 8, 8, 8, 8, 8, 8, 8, 8,
						8, 8, 8, 8, 8, 8, 8, 8, 8, 8, 8, 8, 8, 8, 8, 8,
						1, 1, 1, 1, 2, 2, 2, 2, 1, 1, 1, 1, 2, 2, 2, 2,
						1, 1, 1, 1, 2, 2, 2, 2, 1, 1, 1, 1, 2, 2, 2, 2,
						1, 1, 1, 1, 2, 2, 2, 2, 1, 1, 1, 1, 2, 2, 2, 2,
						1, 1, 1, 1, 2, 2, 2, 2, 1, 1, 1, 1, 2, 2, 2, 2,
						1, 1, 1, 1, 2, 2, 2, 2, 1, 1, 1, 0, 0, 0, 0, 0
					]
				},
				{
					"position": {"x": 2, "y": 1},
					"statics": [
						{
							"name": "dining_hall_desk",
							"positions": [
								{"x": 4, "y": 1},
								{"x": 6, "y": 1}
							]
						},
						{
							"name": "glass_01",
							"positions": [
								{"x": 0, "y": 0, "stretch": {"x": 1, "y": 0}},
								{"x": 9, "y": 0, "stretch": {"x": 6, "y": 0}}
							]
						},
						{
							"name": "glass_02",
							"positions": [
								{"x": 2, "y": 0, "stretch": {"x": 6, "y": 0}}
							]
						},
						{
							"name": "dining_hall_table_01_a",
							"positions": [
								{"x": 7, "y": 4},
								{"x": 9, "y": 4},
								{"x": 12, "y": 4},
								{"x": 14, "y": 4},
								{"x": 7, "y": 7},
								{"x": 9, "y": 7},
								{"x": 12, "y": 7},
								{"x": 14, "y": 7},
								{"x": 7, "y": 10},
								{"x": 9, "y": 10},
								{"x": 12, "y": 10},
								{"x": 14, "y": 10}
							]
						},
						{
							"name": "dining_hall_table_01_b",
							"positions": [
								{"x": 7, "y": 4},
								{"x": 9, "y": 4},
								{"x": 12, "y": 4},
								{"x": 14, "y": 4},
								{"x": 7, "y": 7},
								{"x": 9, "y": 7},
								{"x": 12, "y": 7},
								{"x": 14, "y": 7},
								{"x": 7, "y": 10},
								{"x": 9, "y": 10},
								{"x": 12, "y": 10},
								{"x": 14, "y": 10}
							]
						},
						{
							"name": "dining_hall_table_01_c",
							"positions": [
								{"x": 7, "y": 4},
								{"x": 9, "y": 4},
								{"x": 12, "y": 4},
								{"x": 14, "y": 4},
								{"x": 7, "y": 7},
								{"x": 9, "y": 7},
								{"x": 12, "y": 7},
								{"x": 14, "y": 7},
								{"x": 7, "y": 10},
								{"x": 9, "y": 10},
								{"x": 12, "y": 10},
								{"x": 14, "y": 10}
							]
						}
					],
					"array": [
						2, 2, 2, 2, 1, 1, 1, 1, 2, 2, 2, 2, 1, 1, 1, 1,
						2, 2, 2, 2, 1, 1, 1, 1, 2, 2, 2, 2, 1, 1, 1, 1,
						2, 2, 2, 2, 1, 1, 1, 1, 2, 2, 2, 2, 1, 1, 1, 1,
						2, 2, 2, 2, 1, 1, 1, 1, 2, 2, 2, 2, 1, 1, 1, 1,
						2, 2, 2, 2, 1, 1, 1, 1, 2, 2, 2, 2, 1, 1, 1, 1,
						2, 2, 2, 2, 1, 1, 1, 1, 2, 2, 2, 2, 1, 1, 1, 1,
						2, 2, 2, 2, 1, 1, 1, 1, 2, 2, 2, 2, 1, 1, 1, 1,
						2, 2, 2, 2, 1, 1, 1, 1, 2, 2, 2, 2, 1, 1, 1, 1,
						1, 1, 1, 1, 2, 2, 2, 2, 1, 1, 1, 1, 2, 2, 2, 2,
						1, 1, 1, 1, 2, 2, 2, 2, 1, 1, 1, 1, 2, 2, 2, 2,
						1, 1, 1, 1, 2, 2, 2, 2, 1, 1, 1, 1, 2, 2, 2, 2,
						1, 1, 1, 1, 2, 2, 2, 2, 1, 1, 1, 1, 2, 2, 2, 2,
						1, 1, 1, 1, 2, 2, 2, 2, 1, 1, 1, 1, 2, 2, 2, 2,
						1, 1, 1, 1, 2, 2, 2, 2, 1, 1, 1, 1, 2, 2, 2, 2,
						1, 1, 1, 1, 2, 2, 2, 2, 1, 1, 1, 1, 2, 2, 2, 2,
						1, 1, 1, 1, 2, 2, 2, 2, 1, 1, 1, 1, 2, 2, 2, 2
					]
				},
				{
					"position": {"x": 3, "y": 1},
					"actors": [
						{"name": "dining_hall_belt", "position": {"x": 2, "y": 0}}
					],
					"array": [
						7, 7, 7, 7, 7, 7, 7, 7, 0, 0, 0, 0, 0, 0, 0, 0,
						5, 5, 5, 5, 5, 5, 5, 5, 0, 0, 0, 0, 0, 0, 0, 0,
						6, 6, 6, 6, 6, 6, 6, 6, 0, 0, 0, 0, 0, 0, 0, 0,
						2, 2, 2, 2, 1, 1, 1, 1, 0, 0, 0, 0, 0, 0, 0, 0,
						2, 2, 2, 2, 1, 1, 1, 1, 0, 0, 0, 0, 0, 0, 0, 0,
						2, 2, 2, 2, 1, 1, 1, 1, 0, 0, 0, 0, 0, 0, 0, 0,
						2, 2, 2, 2, 1, 1, 1, 1, 0, 0, 0, 0, 0, 0, 0, 0,
						2, 2, 2, 2, 1, 1, 1, 1, 0, 0, 0, 0, 0, 0, 0, 0,
						1, 1, 1, 1, 2, 2, 2, 2, 0, 0, 0, 0, 0, 0, 0, 0,
						1, 1, 1, 1, 2, 2, 2, 2, 0, 0, 0, 0, 0, 0, 0, 0,
						1, 1, 1, 1, 2, 2, 2, 2, 0, 0, 0, 0, 0, 0, 0, 0,
						1, 1, 1, 1, 2, 2, 2, 2, 0, 0, 0, 0, 0, 0, 0, 0,
						1, 1, 1, 1, 2, 2, 2, 0, 0, 0, 0, 0, 0, 0, 0, 0,
						1, 1, 1, 1, 2, 2, 2, 0, 0, 0, 0, 0, 0, 0, 0, 0,
						1, 1, 1, 1, 2, 2, 0, 0, 0, 0, 0, 0, 0, 0, 0, 0,
						1, 1, 1, 1, 0, 0, 0, 0, 0, 0, 0, 0, 0, 0, 0, 0
					]
				},
				{
					"position": {"x": 0, "y": 2},
					"array": [
						3, 3, 3, 3, 3, 3, 3, 3, 3, 3, 3, 3, 3, 1, 1, 1,
						0, 0, 0, 0, 0, 0, 0, 0, 0, 0, 0, 0, 0, 0, 0, 0,
						0, 0, 0, 0, 0, 0, 0, 0, 0, 0, 0, 0, 0, 0, 0, 0,
						0, 0, 0, 0, 0, 0, 0, 0, 0, 0, 0, 0, 0, 0, 0, 0,
						0, 0, 0, 0, 0, 0, 0, 0, 0, 0, 0, 0, 0, 0, 0, 0,
						0, 0, 0, 0, 0, 0, 0, 0, 0, 0, 0, 0, 0, 0, 0, 0,
						0, 0, 0, 0, 0, 0, 0, 0, 0, 0, 0, 0, 0, 0, 0, 0,
						0, 0, 0, 0, 0, 0, 0, 0, 0, 0, 0, 0, 0, 0, 0, 0,
						0, 0, 0, 0, 0, 0, 0, 0, 0, 0, 0, 0, 0, 0, 0, 0,
						0, 0, 0, 0, 0, 0, 0, 0, 0, 0, 0, 0, 0, 0, 0, 0,
						0, 0, 0, 0, 0, 0, 0, 0, 0, 0, 0, 0, 0, 0, 0, 0,
						0, 0, 0, 0, 0, 0, 0, 0, 0, 0, 0, 0, 0, 0, 0, 0,
						0, 0, 0, 0, 0, 0, 0, 0, 0, 0, 0, 0, 0, 0, 0, 0,
						0, 0, 0, 0, 0, 0, 0, 0, 0, 0, 0, 0, 0, 0, 0, 0,
						0, 0, 0, 0, 0, 0, 0, 0, 0, 0, 0, 0, 0, 0, 0, 0,
						0, 0, 0, 0, 0, 0, 0, 0, 0, 0, 0, 0, 0, 0, 0, 0
					]
				},
				{
					"position": {"x": 1, "y": 2},
					"array": [
						2, 2, 2, 2, 1, 1, 1, 1, 2, 0, 0, 0, 0, 0, 0, 0,
						0, 0, 0, 0, 0, 0, 0, 0, 0, 0, 0, 0, 0, 0, 0, 0,
						0, 0, 0, 0, 0, 0, 0, 0, 0, 0, 0, 0, 0, 0, 0, 0,
						0, 0, 0, 0, 0, 0, 0, 0, 0, 0, 0, 0, 0, 0, 0, 0,
						0, 0, 0, 0, 0, 0, 0, 0, 0, 0, 0, 0, 0, 0, 0, 0,
						0, 0, 0, 0, 0, 0, 0, 0, 0, 0, 0, 0, 0, 0, 0, 0,
						0, 0, 0, 0, 0, 0, 0, 0, 0, 0, 0, 0, 0, 0, 0, 0,
						0, 0, 0, 0, 0, 0, 0, 0, 0, 0, 0, 0, 0, 0, 0, 0,
						0, 0, 0, 0, 0, 0, 0, 0, 0, 0, 0, 0, 0, 0, 0, 0,
						0, 0, 0, 0, 0, 0, 0, 0, 0, 0, 0, 0, 0, 0, 0, 0,
						0, 0, 0, 0, 0, 0, 0, 0, 0, 0, 0, 0, 0, 0, 0, 0,
						0, 0, 0, 0, 0, 0, 0, 0, 0, 0, 0, 0, 0, 0, 0, 0,
						0, 0, 0, 0, 0, 0, 0, 0, 0, 0, 0, 0, 0, 0, 0, 0,
						0, 0, 0, 0, 0, 0, 0, 0, 0, 0, 0, 0, 0, 0, 0, 0,
						0, 0, 0, 0, 0, 0, 0, 0, 0, 0, 0, 0, 0, 0, 0, 0,
						0, 0, 0, 0, 0, 0, 0, 0, 0, 0, 0, 0, 0, 0, 0, 0
					]
				},
				{
					"position": {"x": 2, "y": 2},
					"array": [
						0, 0, 2, 2, 1, 1, 1, 1, 2, 2, 2, 0, 0, 0, 0, 0,
						0, 0, 0, 0, 1, 1, 1, 1, 2, 0, 0, 0, 0, 0, 0, 0,
						0, 0, 0, 0, 0, 0, 0, 0, 0, 0, 0, 0, 0, 0, 0, 0,
						0, 0, 0, 0, 0, 0, 0, 0, 0, 0, 0, 0, 0, 0, 0, 0,
						0, 0, 0, 0, 0, 0, 0, 0, 0, 0, 0, 0, 0, 0, 0, 0,
						0, 0, 0, 0, 0, 0, 0, 0, 0, 0, 0, 0, 0, 0, 0, 0,
						0, 0, 0, 0, 0, 0, 0, 0, 0, 0, 0, 0, 0, 0, 0, 0,
						0, 0, 0, 0, 0, 0, 0, 0, 0, 0, 0, 0, 0, 0, 0, 0,
						0, 0, 0, 0, 0, 0, 0, 0, 0, 0, 0, 0, 0, 0, 0, 0,
						0, 0, 0, 0, 0, 0, 0, 0, 0, 0, 0, 0, 0, 0, 0, 0,
						0, 0, 0, 0, 0, 0, 0, 0, 0, 0, 0, 0, 0, 0, 0, 0,
						0, 0, 0, 0, 0, 0, 0, 0, 0, 0, 0, 0, 0, 0, 0, 0,
						0, 0, 0, 0, 0, 0, 0, 0, 0, 0, 0, 0, 0, 0, 0, 0,
						0, 0, 0, 0, 0, 0, 0, 0, 0, 0, 0, 0, 0, 0, 0, 0,
						0, 0, 0, 0, 0, 0, 0, 0, 0, 0, 0, 0, 0, 0, 0, 0,
						0, 0, 0, 0, 0, 0, 0, 0, 0, 0, 0, 0, 0, 0, 0, 0
					]
				}
			]
		}
	]
}